NO ./assets/textures/north.xpm
SO ./assets/textures/south.xpm
WE ./assets/textures/west.xpm
EA ./assets/textures/east.xpm

F 220,100,0
C 135,206,235

111111111111111
100000000000001
100000000000001
100020020020001
100000000000001
1111111D1111111
100000000000001
100000000000001
100000N00000001
111111111111111
