NO ./assets/textures/north.xpm
SO ./assets/textures/south.xpm
WE ./assets/textures/west.xpm
EA ./assets/textures/east.xpm

F 220,100,0
C 225,30,0

11111111
1000001111
1000000001
1110000001
  1000N001
  11111111
