NO ./assets/textures/north.xpm
SO ./assets/textures/south.xpm
WE ./assets/textures/west.xpm
EA ./assets/textures/east.xpm

F 100,100,100
C 50,50,50

11111111111111111111
10000000010000000001
11111110010001111111
10000010010000000001
100N0000000001000001
11111111100111001111
10000000000000000001
10001111111100000001
10000000000000000001
11111111111111111111
